T    "H !"
+---------------+
|               |
|    *    *     |
|*   *    *  *  |
|*           * *|
|*           * *|
|*  *         * |
|   *     *   * |
|         *     |
+---------------+

+---------------+
|               |
|*   *    *     |
|*   *    *     |
|            * *|
|            * *|
|*  *         * |
|*  *     *   * |
|         *     |
+---------------+

+---------------+
|               |
|*   **   * *   |
|*******  *** * |
| **** *   * ***|
| **** *  ******|
| ******   ** * |
|   * *   *   * |
|         *     |
+---------------+

+---------------+
|               |
|*******  *** * |
|*******  *** * |
|           ** *|
|*        *  * *|
|*******   ** * |
|*******  *** * |
|         *     |
+---------------+

+---------------+
|               |
|*******  *** * |
|*******  *** * |
|      *  *  * *|
|      *  *  * *|
|*******  **  * |
|*******  **  * |
|         *     |
+---------------+

+---------------+
|               |
|***** *  *** * |
|*******  *** * |
|     * * *  *  |
|     * *    *  |
|******   **  * |
|******   **  * |
|         *     |
+---------------+

+---------------+
|               |
|    *    * *   |
|***** *  ***** |
|***** **  * ***|
|***** **  * ***|
|*******   * ** |
|   * *   *   * |
|         *     |
+---------------+

+---------------+
|               |
|               |
|     * *       |
|     * *       |
|     *         |
|     *         |
|               |
|               |
+---------------+
